###################
         G #
#### # ##### # ####
   # #       # #
#### # ##### # ####
#  ..... # .....  #
# ## ### # ### ## #
#  #  ........ #  #
## # # ##### # # ##
#  x #   #  P#    #
# ###### # ###### #
# ............... #
###################
