###################
#        #        #
# ## ### # ### ## #
#                 #
# ## # ##### # ## #
#    #   #   #    #
#### ### # ### ####
   # #       # #
#### # ## ## # ####
       # G #
#### # ##### # ####
   # #   P   # #
#### # ##### # ####
#  ..... #        #
# ## ### # ### ## #
#  #           #  #
## # # ##### # # ##
#  x #   #   #    #
# ###### # ###### #
#                 #
###################
